Absence :	lack, unavailability		
Academic :	scholastic		
Boundary :	bounds, confines
Borrow :	take
Characteristic	:typical
Dialogue	:conversation
Embrace:	accept	
Foriegn:	overseas
Generate:	produce, cause
Highlight	:call attention to	
Incorporate:	include
Justify	:defend, maintain
Knowledge	:understanding, comprehension
Language	:speech, vernacular	
Margin:	edge, gap
Neighbourhood	:area, locality
Obligation:	responsibility	
Portray:	depict	
QualifyL	be eligible
Refused	:decline